ц -> о
э -> и
м -> а
ъ -> н
д -> е
щ -> в
с -> р
ь -> л
ю -> т
ж -> м
б -> ы
я -> д
и -> к
й -> с
з -> п
е -> з
о -> х
н -> я
к -> й
п -> б
ф -> г
л -> ж
ы -> у
а -> ч
у -> ш
ч -> ь
в -> щ
т -> ю
ш -> ц
г -> э
р -> ф
х -> ъ
ё -> ё
